11111111111
11010010001
10010010001
10000000001
10E00000001
11111111111
