11111111111
10010001001
10010001001
10000000001
10000000001
11111111111
